{
    "quadrant_size": [16, 16],
    "coordinates": {
        "B_1": { "x": 0, "y": 0 },
        "B_2": { "x": 1, "y": 0 },
        "B_3": { "x": 2, "y": 0 },
        "B_4": { "x": 3, "y": 0 },
        "B_5": { "x": 4, "y": 0 },
        "B_6": { "x": 5, "y": 0 },
        "B_7": { "x": 6, "y": 0 },
        "B_8": { "x": 7, "y": 0 },
        "B_9": { "x": 0, "y": 1 },
        "B_10": { "x": 1, "y": 1 },
        "B_11": { "x": 2, "y": 1 },
        "B_12": { "x": 3, "y": 1 },
        "B_13": { "x": 4, "y": 1 },
        "B_14": { "x": 5, "y": 1 },
        "B_15": { "x": 6, "y": 1 },
        "B_16": { "x": 7, "y": 1 },
        "B_17": { "x": 0, "y": 2 },
        "B_18": { "x": 1, "y": 2 },
        "B_19": { "x": 2, "y": 2 },
        "B_20": { "x": 3, "y": 2 },
        "B_21": { "x": 4, "y": 2 },
        "B_22": { "x": 5, "y": 2 },
        "B_23": { "x": 6, "y": 2 },
        "B_24": { "x": 7, "y": 2 },
        "B_25": { "x": 0, "y": 3 },
        "B_26": { "x": 1, "y": 3 },
        "B_27": { "x": 2, "y": 3 },
        "B_28": { "x": 3, "y": 3 },
        "B_29": { "x": 4, "y": 3 },
        "B_30": { "x": 5, "y": 3 },
        "B_31": { "x": 6, "y": 3 },
        "B_32": { "x": 7, "y": 3 }
    }
}